6,14,12,10,6,12,12,12,14,10
3,3,6,13,9,2,6,10,3,3
3,3,1,6,14,13,9,1,3,3
3,3,6,9,1,6,10,6,9,3
3,5,9,6,12,9,3,3,2,3
5,12,10,5,12,8,3,3,7,11
6,8,5,10,6,12,9,3,3,1
5,10,2,3,3,2,6,9,5,10
6,13,11,5,9,5,9,6,10,3
5,8,5,12,12,12,12,9,5,9
