6,10,6,12,14,12,14,12,10,2
3,3,5,10,3,4,9,6,9,3
3,3,6,9,7,12,10,7,12,9
1,5,9,6,9,6,9,5,14,8
6,12,12,9,6,9,6,8,5,10
5,10,4,12,13,10,5,12,12,9
6,9,2,6,10,5,12,12,14,10
3,4,11,3,5,10,6,12,9,1
3,6,9,5,10,3,5,12,12,10
5,9,4,12,9,5,12,12,12,9
