6,14,12,10,6,12,10,6,12,10
3,5,10,5,9,2,5,11,2,3
5,10,7,12,12,13,8,7,11,1
6,9,3,4,12,12,12,9,5,10
5,10,5,14,14,10,2,6,12,9
2,3,2,3,1,5,9,5,12,10
3,3,7,9,6,10,2,6,8,3
3,3,5,8,3,5,13,9,6,9
5,13,10,6,9,6,10,6,13,10
4,12,9,5,12,9,5,9,4,9
