4,10,6,12,12,12,10,6,14,10
6,9,5,8,6,10,7,9,3,3
3,4,14,10,3,3,1,6,9,1
5,10,3,5,9,5,10,5,12,10
2,3,5,12,12,10,5,12,10,3
3,3,6,12,10,3,6,10,3,3
3,3,3,4,13,9,1,3,5,11
7,9,7,12,12,10,6,9,6,9
3,4,9,6,12,9,7,12,9,2
5,12,12,9,4,12,13,12,12,9
